111111111111111
100000000000001
10000P000000001
100000000000001
1000000000000E1
111111111111111
