111111111111111111111
100E000000001P1000001
100C00000000111000001
111111111111111111111