1111111111111111111111
1000000000000000000001
1000000000000000000001
10P0011111000111100001
1000010001000100010001
1000010001000100010001
1000011111000111110001
1000010001000100010001
1000010001000100010001
1000010001000100010001
1000010001000100010001
1000111100001000100001
1000C00000000000000001
1000000000000000000001
1000000000000000000001
1000E00000000000000001
1000000000000000000001
1000000000000000000001
1000000000000000000001
1111111111111111111111