111111111111111111111
100E000000001C1000001
100P00000000111000001
111111111111111111111