111111111111111111111
100P000000001E1000001
100C00000000111000001
111111111111111111111