1111111111111111111111
1000000000000000000001
1000000000000000000001
1000010001000111110001
10P0010001000000010001
1000010001000000010001
1000011111000111110001
1000000001000100000001
1000000001000100000001
1000000001000100000001
1000000001000111110001
1000000000000000000001
1000C0000000C0000000C1
1000000000000000000001
1000000000000000000001
1000E00000000000000001
1000000000000000000001
1000000000000000000001
1000000000000000000001
1111111111111111111111