111111111111111111111
101E100000001C1000001
10111000P000111000001
111111111111111111111